000000000000000000000000000000000000000000000000000000
000000000000000000000000000000000000000000000000000000
000000000000000000000000000000000000000000000000000000
000000000000000011111111111111100000000000011011000000
000000000000111111111111111111111000000000000111000000
000000000000111111111111111111111111000000000001000000
000000000001111111111111111111111111100000000000000000
000000000101111111111111111111111111100000000000000000
000000000101111110000111111111111111110000000011000000
000000000000111111000011111111111111110000000111100000
000000000001111110000011111111111111111000000000000000
000000000001111111111111111111111111111000000001110000
000000000011111111111111111111111111111100001111100000
000000000011111111111111111111111111111100001111100000
000000000011111111111111111111111111111000000011100000
000000000111111111111111111111111111111100000000000000
000000000111111111111111111111111111111100000000000000
000000000001111111111111111111111111111000000000000000
000000000001111111111111111111111111111000000000000000
000000000001111111111111111111111111111000000000000000
000000000000011111111111111111111111110000000000000000
000000000000011111111111111111111111110000000000000000
000000000000001111110000001111111111110000000000000000
000000000000000011111000011111111111100000000000000000
000000000000000011111101111111111100000000000000000000
000000000000000001111101111111111000000000000000000000
000000000000000000011101111111000000000000000000000000
000000000000000000000000000000000000000000000000000000
000000000000000000000000000000000000000000000000000000
000000000000000000000000000000000000000000000000000000